5
10
##########
##....Z.##
##@.....##
##.....P##
##########